###########
#p...#...p#
#.##.#.##.#
#.#.mmm.#.#
#.#.###.#.#
 .........
#.#.###.#.#
#.#..o..#.#
#.##.#.##.#
#p...#...p#
###########
