#############
#....#......#
#.##.#.##...#
#.#.....#...#
#.#.###.#...#
#...........#
#.#.###.#...#
#.#...o...#.#
#.##.#.##...#
#....#......#
#############
